18 20
75 100
17 8 8 8 14 2 1 1 1 1 1 1 1 1 1 1 1 1
15 6 5 5 15 2 1 1 1 1 1 1 1 1 1 1 1 1
15 4 1 1 15 2 1 1 1 1 1 1 1 1 1 1 1 1
15 2 1 1 15 2 1 1 1 1 1 1 1 1 1 1 1 1
15 2 1 1 15 2 1 1 1 1 1 1 1 1 1 1 1 1
15 2 1 3 15 2 1 1 1 1 1 1 1 1 1 1 1 1
15 2 1 1 15 2 1 1 1 1 1 1 1 1 1 1 1 1
5 2 1 1 15 2 1 1 1 1 1 1 1 1 1 1 1 1
1 1 1 1 5 2 1 1 1 1 1 1 1 1 1 1 1 1
1 1 1 1 1 1 1 1 1 1 1 1 1 1 1 1 1 1
1 1 1 1 1 1 1 1 1 1 1 1 1 1 1 1 1 1
1 1 1 1 1 1 1 1 1 1 1 1 1 1 1 1 1 1
1 1 1 1 1 1 1 1 1 1 1 1 1 1 1 1 1 1
1 1 1 1 1 1 1 1 1 1 1 1 1 1 1 1 1 1
1 1 1 1 1 1 1 1 1 1 1 1 1 1 1 1 1 1
1 1 1 1 1 1 1 1 1 1 1 1 1 1 1 1 1 1
1 1 1 1 1 1 1 1 1 1 1 1 1 1 1 1 1 1
1 1 1 1 1 1 1 1 1 1 1 1 1 1 1 1 1 1
1 1 1 1 1 1 1 1 1 1 1 1 1 1 1 1 1 1
1 1 1 1 1 1 1 1 1 1 1 1 1 1 1 1 1 1


width, height
spawn x, spawn y
map design